WE textur/sh3.png

SO textur/uchi1.png
NO textur/uchi2.png

EA textur/uchi3.png

C 50,50,50

F 255,20,255

111111111111111
100000100000001
10000111111111111111111111
10S00011000000000000010001
10000010000000000000000001
10000011000000000000010001
111D1111111D11111111110001
110000110000001      10001
100000010000001      10001
100000010000001      10001
1000000D000000111111111D11111111111
10000001000000100000000000000000001
100000010000001000000000000000000011111
110000110000001001100000000000110010001
111111111111111001000000000000010010001
              1000000000000000000010001
              1000000000000000000010001
              10000000000000000000D0001
              1000000000000000000010001
              1000000000000000000010001
              1001000000000000010010001
              1001100000000000110010001
              1000000000000000000010001
              1000000000000000000010001
              1111111111111111111111111