WE textur/uchi4.png

SO textur/uchi1.png

NO textur/uchi2.png

EA textur/uchi3.png

F 255,0,20
C 50,50,0

1111
10001
10W01
10001
1111