WE textur/sh3.png

SO textur/uchi1.png
NO textur/uchi2.png

EA textur/uchi3.png

C 50,50,50

F 0,0,0

111111111111111
100000100000001
111D1100000001
100000100000001
10000111111111111111111111
10S00011000000000000010001
10000000000000000000000001
10000011000000000000010001
111D1111111011111111110001
110000110000001      10001
100000010000001      10001
100000010000001      10001
10000000000000111111111011111111111
10000001000000100000000000000000001
10000001000000100000000000000000001
11000011000000111111111111111111111
111111111111111