WE textur/sh3.png

SO textur/uchi1.png

NO textur/uchi2.png

EA textur/uchi3.png

F 255,0,0
C 50,50,50




        1111111111111111111111111
        1000000000110000000000001
        1011000001110000000000001
        1001000000000000000000001
111111111011000001110000000000001
100000000011000001110111111111111
11110111111111011100000010001
11110111111111011101010010001
11000000110101011100000010001
10000000000000000000000000001
10000000000000000000000000001
10000000000000000000000000001
10000000000000010000000000001
10000000000000000000000000001
10000000000000000000000000001
100000000000000E0000000100001
10000000000000000000000000001
10000000000000000000000000001
10000000000000000000000000001
10000000000000000000000000001
10000000000000000000000000001
10000000000000000000000000001
10000000000000001101010010001
11000001101010111110111100011
11110111 1110101 101111010001
11111111 1111111 111111111111