WE textur/sh3.png

SO textur/uchi1.png
NO textur/uchi2.png

EA textur/uchi3.png

F 220,100,0
C 225,30,0

1111111111111111
1111100000000001
111110N0000010001
111110000000D0001
11111000001D10001
11111000000000001
1111111111111111