WE textur/sh3.png

SO textur/uchi1.png
NO textur/uchi2.png

EA textur/uchi3.png

F 220,100,0
C 225,30,0

111111111111111111111111111111111111111111111111111
100000000000000000000000000000000000000000000000001
100000000000000000000000000000000000000000000000001
100000000000000000000000000000000000000000000000001
1000E0000000000000000000000000000000000000000000001
100000000000000000000000000000000000000000000000001
100000000000000000000000000000000000000000000000001
100000000000000000000000000000000000000000000000001
111111111111111111111111111111111111111111111111111