F   10, 100, 89

C 150, 150, 150

111111111111111111111111
100000010100000000000001
100000010100001000000001
10000001010S00D000000001
100000110100001000000001
10011111D100000000000001
100000000000000000000001
100000000000000000000001
111111111111111111111111